R 640 480

NO ./textures/64/BR1.xpm
SO ./textures/64/BR2.xpm
WE ./textures/64/Grey1.xpm
EA ./textures/64/Orange1.xpm
S ./textures/64/Barrel.xpm

CT ./textures/64/Stone2.xpm
FT ./textures/64/Stone1.xpm

F 220,100,10
C 225,30,10

        1111111111111111111111111
        1000000000110000202000001
        1011000001110E00022000001
        1001000000000000000000001
111111111011000001110000000000001
100000000011000001110111111111111
11110111111111011100000010001
11110111111111011101010010001
11000000110101011100000010001
10002000000000001100000010001
10000000000000001101010010001
1100000111010101111101111000111
11110111 1110101 101111010001
11111111 1111111 111111111111
