R 1920 1080

NO ./textures/256/Wall-5.xpm
SO ./textures/256/Wall-6.xpm
WE ./textures/256/Wall-3.xpm
EA ./textures/256/Wall-4.xpm
S ./textures/256/Tree.xpm

FT ./textures/256/Asphalt.xpm
ST ./textures/Skybox.xpm

F 220,100,10
C 225,30,10

        1111111111111111111111111
        1200000000110000022000001
        1011000001110000002200001
        1001000000000000N00000001
111111111011000001110000000000001
120000000011000001110111111111111
11110111111111011100000010001
11110111111111011101010010001
11000000110101011100000010001
10002000000000001100000010001
10000000000000001101010010001
1100000111010101111101111000111
11110111 1110101 101111010001
11111111 1111111 111111111111
